####################
####################
#..................#
#..................#
#..................#
#..................#
........#..........#
........#..........#
...................#
...................#
........#..........#
...................#
...................#
....#######........#
...................#
...................#
...................#
...................#
####################
####################