....................
.....###########....
............####....
....................
....................
....................
....................
....................
....................
.....######.........
....................
....................
.............#......
....................
....................
.....##########.....
....................
....................
....................
#..................#